C;C;W;P;C;C;C;C;C;C;C;C;D;S;S;C;C
.;.;.;.;.;.;.;.;G;.;.;.;.;.;.;.;.
Y;Y;Y;Y;Y;Y;.;.;O;.;.;Y;Y;Y;Y;Y;Y
X;C;X;C;Y;Y;.;.;O;.;.;Y;Y;C;T;C;T
.;.;.;.;STAIRS;STAIRS;.;.;C;.;.;STAIRS;STAIRS;.;.;.;.
.;.;SECOND;.;STAIRS;STAIRS;.;.;C;.;.;STAIRS;STAIRS;.;FIRST;.;.
K;C;K;C;Y;Y;.;.;O;.;.;Y;Y;C;K;C;K
Y;Y;Y;Y;Y;Y;.;.;O;.;.;Y;Y;Y;Y;Y;Y
.;.;.;.;.;.;.;.;C;.;.;.;.;.;.;.;.
C;C;C;C;M;C;C;C;C;C;C;C;I;F;C;C;C
